10 5 10 60
01 06 00 00 18 00 00 01 01 01
01 01 00 00 06 00 00 01 01 01
01 01 00 00 00 00 00 01 01 01
01 00 00 00 00 00 00 00 01 00
01 00 00 00 00 00 00 00 01 00
01 00 00 00 00 00 00 00 01 00
01 00 00 00 00 00 00 00 01 00
01 00 00 00 00 00 00 01 01 01
01 01 00 00 00 00 00 01 04 01
01 01 00 00 00 00 00 01 01 01

00 00 00 00 00 00 00 11 11 11
00 10 00 00 00 00 00 11 00 10
00 00 00 00 00 00 00 11 11 11
00 00 00 00 00 00 00 00 00 00
00 00 00 00 00 00 00 00 00 00
00 00 00 00 00 00 00 00 00 00
00 00 00 00 00 00 00 00 00 00
00 00 00 00 00 00 00 00 00 00
00 99 00 00 00 00 00 00 00 00
00 00 00 00 00 00 00 00 00 00

00 00 00 00 00 00 00 00 00 00
00 00 00 00 00 00 00 00 00 00
00 00 00 00 00 00 00 00 00 00
00 00 00 00 00 00 00 00 00 00
00 00 00 00 00 00 00 00 00 00
00 00 00 00 00 00 00 00 00 00
00 00 00 00 00 00 00 00 00 00
00 00 00 00 00 00 00 00 00 00
00 00 00 00 00 00 00 00 00 00
00 00 00 00 00 00 00 00 00 00

00 00 00 00 00 00 00 00 00 00
00 01 01 16 00 00 00 18 00 00
00 01 01 01 00 00 00 01 01 01
00 18 01 01 00 00 00 07 01 01
00 00 00 00 00 00 00 01 01 01
00 00 00 00 00 00 00 00 00 00
00 00 00 00 00 00 00 00 00 00
00 16 01 09 01 00 00 01 09 01
00 00 01 01 01 00 00 07 01 01
00 00 01 01 01 00 00 01 01 01

00 00 00 00 00 00 00 00 00 00
00 00 00 00 00 00 00 00 00 00
00 00 10 00 00 00 00 11 00 00
00 00 00 00 00 00 00 00 10 00
00 00 00 00 00 00 00 00 00 11
00 00 00 00 00 00 00 00 00 00
00 00 00 00 00 00 00 00 00 00
00 00 11 00 00 00 00 00 00 00
00 00 00 10 00 00 00 00 00 00
00 00 00 00 11 00 00 00 00 00