11 4 12 999

01 01 01 00 02 00 02 00 03 03 00
00 01 00 00 02 00 02 00 03 00 00 
00 01 00 00 02 02 02 00 03 03 00
00 01 00 00 02 00 02 00 03 00 00
00 01 00 00 02 00 02 00 03 03 00
00 00 00 00 00 00 00 00 00 00 00
00 00 00 00 00 00 00 00 00 00 00
01 01 00 02 00 00 02 00 03 03 00
01 00 00 02 02 00 02 00 03 00 03
01 01 00 02 00 02 02 00 03 00 03
01 00 00 02 00 00 02 00 03 00 03
01 01 00 02 00 00 02 00 03 03 00

01 01 01 00 02 00 02 00 03 03 00
00 01 00 00 02 00 02 00 03 00 00 
00 01 00 00 02 10 02 00 03 03 00
00 01 00 00 02 00 02 00 03 00 00
00 01 00 00 02 00 02 00 03 03 00
00 00 00 00 00 00 00 00 00 00 00
00 00 00 00 00 00 00 00 00 00 00
01 01 00 02 00 00 02 00 03 03 00
01 00 00 02 02 00 02 00 03 00 03
01 01 00 02 00 02 02 00 03 00 03
01 00 00 02 00 00 02 00 03 00 03
01 01 00 02 00 00 02 00 03 03 00

01 01 01 00 02 00 02 00 03 03 00
00 01 00 00 02 00 02 00 03 00 00 
00 01 00 00 02 02 02 00 03 03 00
00 01 00 00 02 00 02 00 03 00 00
00 01 00 00 02 00 02 00 03 03 00
00 00 00 00 00 00 00 00 00 00 00
00 00 00 00 00 00 00 00 00 00 00
01 01 00 02 00 00 02 00 03 03 00
01 00 00 02 02 00 02 00 03 00 03
01 01 00 02 00 02 02 00 03 00 03
01 00 00 02 00 00 02 00 03 00 03
01 01 00 02 00 00 02 00 03 03 00

00 00 00 00 00 00 00 00 00 00 00
00 00 00 00 00 00 00 00 00 00 00
00 00 00 00 00 00 00 00 00 00 00
00 00 00 00 00 00 00 00 00 00 00
00 00 00 00 00 00 00 00 00 00 00
00 00 00 00 00 00 00 00 00 00 00
00 00 00 00 00 99 00 00 00 00 00
00 00 00 00 00 00 00 00 00 00 00
00 00 00 00 00 00 00 00 00 00 00
00 00 00 00 00 00 00 00 00 00 00
00 00 00 00 00 00 00 00 00 00 00
00 00 00 00 00 00 00 00 00 00 00